-                                    -
-                                    -
-                                    -
-                                    -
-                                    -
-                                    -
-                                    -
-      *                      *      -
-   ----                      ----   -
-                                    -
-         *                *         -
--     ----                ----     --
-                                    -
-      *                      *      -
-      -                      -      -
-    ------     ------     ------    -
-      -  -     ------     -  -      -
-      -  -                -  -      -
---    -  -                -  -    ---
-      -                      -      -
-                                    -
-          ----        ----          -
-------------            -------------
-------------            -------------