-                                    -
-                                    -
-                                    -
-                                    -
-    ----                    ----    -
-       *                    *       -
--      -                    -       -
-     ----                  ----     -
-       *                    *       -
-       -                    -       -
-----  --                    --  -----
-       *                    *       -
-       -                    -       -
-   -----                    -----   -
-       -                    -       -
-       ---                ---       -
-----            -----           -----
-                -----               -
-                                    -
-            *           *           -
---   --   ----         ----   --  ---
-      -    -             -    -     -
-      -    -             -    -     -
-      -    -             -    -     -